0 0 0 0 0 0 0 0 2 5 0 0 0 0 0 0 0 0 0 0
0 2 5 1 5 5 5 0 2 5 0 0 0 0 0 0 0 0 0 0
0 0 3 3 3 4 1 0 2 1 0 0 0 0 0 0 0 0 0 0
0 0 0 0 0 2 5 0 2 5 0 0 0 0 0 0 0 0 0 0
0 0 0 0 0 2 1 0 2 1 1 0 0 0 0 0 0 0 0 0
0 2 1 5 0 2 5 0 0 4 5 0 0 0 0 0 0 0 0 0
0 2 5 5 0 2 5 0 0 2 5 0 0 0 0 0 0 0 0 0
0 2 5 1 0 2 1 0 0 2 5 1 0 0 2 5 1 0 0 0
0 0 3 3 0 2 5 1 5 5 5 1 5 5 5 5 1 0 0 0
0 0 0 0 0 0 3 3 3 3 3 3 3 3 3 3 3 0 0 0
0 0 0 0 0 0 0 0 0 0 0 0 0 0 0 0 0 0 0 0
0 0 0 0 0 0 0 0 0 0 0 0 0 0 0 0 0 0 0 0