1 002 1 005 1 010 1 014 1 017
1 020 1 026 1 030 1 033 1 035
9 050 1 053 2 056 1 058 2 060
2 063 2 066 1 070 2 070 1 075
2 077 9 090 3 092 1 093 2 094
2 096 3 100 1 101 1 102 1 103
1 104 2 106 3 110 1 110 2 111
3 112 1 113 9 128 2 130 1 131
3 132 4 133 4 135 4 140 1 140
2 141 3 143 1 144 1 145 1 146
4 148 4 150 2 151 1 152 3 153
4 155 4 156 9 170 2 172 2 175
4 177 3 180 5 185 1 195 3 200
9 210 4 212 3 212 2 212 1 212
3 214 1 215 2 216 4 217 4 218
3 219 1 220 2 221 3 222 4 223
5 225 4 227 9 240 6 244 9 800